3 32 24
tileset1

1 1 1 1 1 1 1 1 1 1 1 1 1 0 0 0 1 1 1 1 1 1 1 1 1 1 1 1 1 1 1 1 
1 1 1 1 1 1 1 1 1 1 1 1 1 0 0 0 1 1 1 1 1 1 1 1 1 1 1 1 1 1 1 1 
1 1 1 1 1 1 1 1 1 1 1 1 1 0 0 0 1 1 1 1 1 1 1 1 1 1 1 1 1 1 1 1 
1 1 1 1 1 1 1 1 1 1 1 1 1 0 0 0 1 1 1 1 1 1 1 1 1 1 1 1 1 1 1 1 
1 1 1 1 1 0 0 0 0 0 0 0 0 0 0 0 0 0 0 0 0 0 0 0 1 1 1 1 1 1 1 1 
1 1 1 1 1 0 0 0 0 0 0 0 0 0 0 0 0 0 0 0 0 0 0 0 1 1 1 1 1 1 1 1 
1 1 1 1 1 0 0 1 1 1 1 1 0 0 0 0 0 1 1 1 1 1 0 0 1 1 1 1 1 1 1 1 
1 1 1 1 1 0 0 1 1 1 1 1 0 0 0 0 0 1 1 1 1 1 0 0 1 1 1 1 1 1 1 1 
1 1 1 1 1 0 0 1 1 1 1 1 0 0 0 0 0 1 1 1 1 1 0 0 1 1 1 1 1 1 1 1 
1 1 1 1 1 0 0 1 0 1 1 1 1 0 0 0 1 1 0 1 1 1 0 0 1 1 1 1 1 1 1 1 
1 1 1 1 1 0 0 0 0 0 0 0 0 0 0 0 0 0 0 0 0 0 0 0 1 1 1 1 1 1 1 1 
1 1 1 1 1 0 0 0 0 0 0 0 0 0 0 0 0 0 0 0 0 0 0 0 1 1 1 1 1 1 1 1 
1 1 1 1 1 0 0 1 1 1 1 1 1 0 0 0 0 0 0 0 0 0 0 0 1 1 1 1 1 1 1 1 
1 1 1 1 1 0 0 1 0 0 0 0 0 0 0 0 1 1 1 1 1 1 1 0 1 1 1 1 1 1 1 1 
1 1 1 1 1 0 0 1 0 0 0 0 0 0 0 0 1 1 1 1 1 1 1 0 1 1 1 1 1 1 1 1 
1 1 1 1 1 0 0 1 0 0 0 0 0 0 0 0 1 1 1 1 1 1 1 0 1 1 1 1 1 1 1 1 
1 1 1 1 1 0 0 1 0 0 0 0 0 0 0 0 1 1 1 1 1 1 1 0 1 1 1 1 1 1 1 1 
1 1 1 1 1 0 0 0 0 0 0 0 0 0 0 0 0 0 0 0 0 0 0 0 1 1 1 1 1 1 1 1 
1 1 1 1 1 0 0 0 0 0 0 0 0 0 0 0 0 0 0 0 0 0 0 0 1 1 1 1 1 1 1 1 
1 1 1 1 1 0 0 0 0 0 0 0 0 0 0 0 0 0 0 0 0 0 0 0 1 1 1 1 1 1 1 1 
1 1 1 1 1 0 0 0 0 0 0 0 0 2 2 2 0 0 0 0 0 0 0 0 1 1 1 1 1 1 1 1 
1 1 1 1 1 0 0 0 0 0 0 0 0 2 2 2 0 0 0 0 0 0 0 0 1 1 1 1 1 1 1 1 
1 1 1 1 1 0 0 0 0 0 0 0 0 2 2 2 1 1 1 1 1 1 1 1 1 1 1 1 1 1 1 1 
1 1 1 1 1 0 0 0 0 0 0 0 0 2 2 2 1 0 0 0 0 0 0 0 1 1 1 1 1 1 1 1 
271 271 271 271 271 271 271 271 271 271 271 271 271 277 278 279 271 271 271 271 271 271 271 271 271 271 271 271 271 271 271 271 
271 271 271 271 271 271 271 271 271 271 271 271 271 283 284 285 271 271 271 271 271 271 271 271 271 271 271 271 271 271 271 271 
271 271 271 271 271 271 271 271 271 271 271 271 271 283 284 285 271 271 271 271 271 271 271 271 271 271 271 271 271 271 271 271 
271 271 271 271 271 271 271 271 271 271 271 271 271 283 284 285 271 271 271 271 271 271 271 271 271 271 271 271 271 271 271 271 
271 271 271 271 271 271 271 271 271 271 271 271 271 283 284 285 271 271 271 271 271 271 271 271 271 271 271 271 271 271 271 271 
271 271 271 271 271 271 271 271 271 271 271 271 271 283 284 285 271 271 271 271 271 271 271 271 271 271 271 271 271 271 271 271 
271 271 271 271 271 271 271 271 271 271 271 271 271 283 284 285 271 271 271 271 271 271 271 271 271 271 271 271 271 271 271 271 
271 271 271 271 271 271 271 271 271 271 271 271 271 283 284 285 271 271 271 271 271 271 271 271 271 271 271 271 271 271 271 271 
271 271 271 271 271 271 271 271 271 271 271 271 271 283 284 285 271 271 271 271 271 271 271 271 271 271 271 271 271 271 271 271 
271 271 271 271 271 271 271 271 271 271 271 271 271 283 284 285 271 271 271 271 271 271 271 271 271 271 271 271 271 271 271 271 
271 271 271 271 271 271 271 277 278 278 278 278 278 280 284 281 278 278 278 278 278 279 271 271 271 271 271 271 271 271 271 271 
271 271 271 271 271 271 271 283 284 284 284 284 284 284 284 284 284 284 284 284 284 285 271 271 271 271 271 271 271 271 271 271 
271 271 271 271 271 271 271 289 290 290 290 290 290 286 284 287 290 290 290 290 290 291 271 271 271 271 271 271 271 271 271 271 
271 271 271 271 271 271 271 271 271 271 271 271 272 283 284 285 271 271 271 271 271 271 271 271 271 271 271 271 271 271 271 271 
271 271 271 271 271 271 271 271 272 384 396 271 271 283 284 285 271 271 271 271 271 271 271 271 271 271 271 271 271 271 271 271 
271 271 271 271 271 271 271 271 271 390 402 271 271 283 284 285 271 271 271 271 271 271 271 271 271 271 271 271 271 271 271 271 
271 271 271 271 271 271 271 271 271 271 273 271 271 283 284 285 271 271 271 284 271 271 271 271 271 271 271 271 271 271 271 271 
271 271 271 271 271 271 271 277 278 278 278 278 278 280 284 281 278 278 280 284 281 278 279 271 271 271 271 271 271 271 271 271 
271 271 271 271 271 271 271 289 290 290 290 290 290 290 290 290 290 290 290 290 290 290 291 271 271 271 271 271 271 271 271 271 
271 271 271 271 271 271 271 271 271 271 271 271 271 271 271 271 271 271 271 271 271 271 271 271 271 271 271 271 271 271 271 271 
271 271 271 271 271 271 271 271 271 271 271 271 271 271 271 271 271 271 271 271 271 271 271 271 271 271 271 271 271 271 271 271 
271 271 271 271 271 271 271 271 271 271 271 271 271 271 271 271 271 271 271 271 271 271 271 271 271 271 271 271 271 271 271 271 
271 271 271 271 271 271 271 271 271 271 271 271 271 271 271 271 271 271 271 271 271 271 271 271 271 271 271 271 271 271 271 271 
271 271 271 271 271 271 271 271 271 271 271 271 271 271 271 271 271 271 271 271 271 271 271 271 271 271 271 271 271 271 271 271 

387 388 387 388 387 388 387 386 387 388 387 388 389 20 20 20 391 388 387 388 387 388 387 388 387 388 387 388 387 388 387 388 
387 388 387 388 387 388 387 386 387 388 387 388 389 20 20 20 385 388 387 388 387 388 387 388 387 388 387 388 387 388 387 388 
387 388 387 386 405 394 393 394 393 394 393 394 395 20 20 20 391 392 393 392 393 392 393 392 393 388 387 388 387 388 387 388 
387 388 387 388 399 400 399 400 399 400 399 400 401 20 20 20 397 398 399 398 399 398 399 398 399 388 387 388 387 388 387 388 
387 388 387 388 389 20 20 20 20 20 20 20 20 20 20 20 20 20 20 20 20 20 20 20 385 388 387 388 387 388 387 388 
387 388 387 388 389 20 20 20 20 20 20 20 20 20 20 20 20 20 20 20 20 20 20 20 385 388 387 388 387 388 387 388 
387 388 387 388 389 20 20 349 350 350 350 353 20 20 20 20 20 349 350 352 352 353 20 20 385 388 387 388 387 388 387 388 
387 388 387 388 389 20 20 355 20 20 356 359 20 20 20 20 20 355 356 356 357 359 20 20 385 388 387 388 387 388 387 388 
387 388 387 388 389 20 20 361 362 363 364 365 20 20 20 20 20 361 362 363 364 365 20 20 385 388 387 388 387 388 387 388 
387 388 387 388 389 20 20 367 368 369 370 371 372 20 20 20 372 367 368 369 370 371 20 20 385 388 387 388 387 388 387 388 
387 388 387 388 389 20 20 373 374 375 376 377 20 20 20 20 20 373 374 375 376 377 20 20 385 388 387 388 387 388 387 388 
387 388 387 388 389 20 20 20 20 20 20 20 20 20 20 20 20 20 20 20 20 20 20 20 385 388 387 388 387 388 387 388 
387 388 387 388 389 20 20 199 212 212 212 212 203 20 20 20 20 20 20 20 20 20 20 20 385 388 387 388 387 388 387 388 
387 388 387 388 389 20 20 205 20 20 20 20 20 20 20 20 457 458 458 458 458 462 432 20 385 388 387 388 387 388 387 388 
387 388 387 388 389 20 20 205 20 20 20 20 20 20 20 20 463 464 464 464 464 468 438 20 385 388 387 388 387 388 387 388 
387 388 387 388 389 20 20 205 20 20 20 20 20 20 20 20 469 470 471 472 473 474 444 20 385 388 387 388 387 388 387 388 
387 388 387 388 389 20 20 214 20 20 20 20 20 20 20 20 475 476 477 478 479 480 450 20 385 388 387 388 387 388 387 388 
387 388 387 388 389 20 20 20 20 20 20 20 20 20 20 20 481 483 483 483 483 483 487 20 385 388 387 388 387 388 387 388 
387 388 387 388 389 20 20 20 20 20 20 20 20 20 20 20 20 20 20 20 20 20 20 20 385 388 387 388 387 388 387 388 
387 388 387 388 389 20 20 20 20 20 20 20 20 20 20 20 20 20 20 20 20 20 20 20 385 388 387 388 387 388 387 388 
387 388 387 388 389 20 20 20 20 20 20 20 20 181 182 183 20 20 20 20 20 20 20 20 385 388 387 388 387 388 387 388 
387 388 387 388 389 20 20 20 20 20 20 20 20 187 188 189 20 20 20 20 20 20 20 20 385 388 387 388 387 388 387 388 
387 388 387 388 389 20 20 20 20 20 20 20 20 187 188 189 199 212 212 212 212 212 212 212 212 388 387 388 387 388 387 388 
387 388 387 388 389 20 20 20 20 20 20 20 20 187 188 189 205 20 20 20 20 20 20 20 385 388 387 388 387 388 387 388 

20 20 20 20 20 20 20 20 20 20 20 20 20 20 20 20 20 20 20 20 20 20 20 20 20 20 20 20 20 20 20 20 
20 20 20 20 20 20 20 20 20 20 20 20 20 20 20 20 20 20 20 20 20 20 20 20 20 20 20 20 20 20 20 20 
20 20 20 20 383 20 20 20 20 20 20 20 20 20 20 20 20 20 20 20 20 20 20 20 379 20 20 20 20 20 20 20 
20 20 20 20 389 20 20 20 20 20 20 20 20 20 20 20 20 20 20 20 20 20 20 20 385 20 20 20 20 20 20 20 
20 20 20 20 20 20 20 20 20 20 20 20 20 20 20 20 20 20 20 20 20 20 20 20 20 20 20 20 20 20 20 20 
20 20 20 20 20 20 20 343 344 344 344 347 20 20 20 20 20 343 344 344 344 347 20 20 20 20 20 20 20 20 20 20 
20 20 20 20 20 20 20 20 20 20 20 20 20 20 20 20 20 20 20 20 20 20 20 20 20 20 20 20 20 20 20 20 
20 20 20 20 20 20 20 20 356 356 20 20 20 20 20 20 20 20 20 20 20 20 20 20 20 20 20 20 20 20 20 20 
20 20 20 20 20 20 20 361 362 363 20 20 366 20 20 20 366 20 20 20 20 20 20 20 20 20 20 20 20 20 20 20 
20 20 20 20 20 20 20 20 20 20 20 20 20 20 20 20 20 20 20 20 20 20 20 20 20 20 20 20 20 20 20 20 
20 20 20 20 20 20 20 20 20 20 20 20 20 20 20 20 20 20 20 20 20 20 20 20 20 20 20 20 20 20 20 20 
20 20 20 20 20 20 20 20 20 20 20 20 20 20 20 20 20 20 20 20 20 20 20 20 20 20 20 20 20 20 20 20 
20 20 20 20 20 20 20 20 20 20 20 20 20 20 20 20 451 452 452 452 452 456 426 20 20 20 20 20 20 20 20 20 
20 20 20 20 20 20 20 20 20 20 20 20 20 20 20 20 20 20 20 20 20 20 20 20 20 20 20 20 20 20 20 20 
20 20 20 20 20 20 20 20 20 20 20 20 20 20 20 20 20 20 20 20 20 20 20 20 20 20 20 20 20 20 20 20 
20 20 20 20 20 20 20 20 20 20 20 20 20 20 20 20 20 20 20 20 20 20 20 20 20 20 20 20 20 20 20 20 
20 20 20 20 20 20 20 20 20 20 20 20 20 20 20 20 20 20 20 20 20 20 20 20 20 20 20 20 20 20 20 20 
20 20 20 20 20 20 20 20 20 20 20 20 20 20 20 20 20 20 20 20 20 20 20 20 20 20 20 20 20 20 20 20 
20 20 20 20 20 20 20 20 20 20 20 20 20 20 20 20 20 20 20 20 20 20 20 20 20 20 20 20 20 20 20 20 
20 20 20 20 20 20 20 20 20 20 20 20 20 20 20 20 20 20 20 20 20 20 20 20 20 20 20 20 20 20 20 20 
20 20 20 20 20 20 20 20 20 20 20 20 20 20 20 20 20 20 20 20 20 20 20 20 20 20 20 20 20 20 20 20 
20 20 20 20 20 20 20 20 20 20 20 20 20 20 20 20 20 20 20 20 20 20 20 20 20 20 20 20 20 20 20 20 
20 20 20 20 20 20 20 20 20 20 20 20 20 20 20 20 20 20 20 20 20 20 20 20 385 20 20 20 20 20 20 20 
20 20 20 20 20 20 20 20 20 20 20 20 20 20 20 20 20 20 20 20 20 20 20 20 20 20 20 20 20 20 20 20 
# TP 3 15 0 16 37 1
# TP 3 14 0 15 37 1
# TP 3 13 0 15 37 1
# ANIM_TILE 8 8 3 368 0.6 360 0.1 354 0.1 2 8 8 0 1 0 0
# ANIM_TILE 8 8 3 354 0.6 360 0.1 368 0.1 1 8 8 1 0 0 0
# TP 2 8 8 4 11 0 
@
