3 16 14
indoor

1  1  1  1  1  1  1  1  1  1  1  1  1  1  1  1
1  1  1  1  1  1  1  1  1  1  1  1  1  1  1  1
1  1  1  1  0  0  0  0  0  1  1  0  0  0  0  1
1  0  0  0  0  0  0  0  0  1  1  0  0  0  0  1
1  0  0  0  0  0  0  0  0  1  1  0  0  0  0  1
1  1  1  1  1  1  1  0  0  0  1  0  0  0  0  1
1  0  0  0  0  0  0  0  0  0  0  0  0  0  0  1
1  1  0  0  0  0  0  0  0  0  0  0  0  0  1  1
1  0  0  0  0  0  0  0  1  1  0  0  0  0  0  1
1  0  0  0  0  0  0  0  1  1  0  0  0  0  0  1
1  0  0  0  0  0  0  0  0  0  0  0  0  0  0  1
1  1  0  0  0  0  0  0  0  0  0  0  0  0  1  1
1  0  0  0  0  0  0  0  0  0  0  0  0  0  0  1
1  1  1  1  0  1  1  1  1  1  1  1  1  1  1  1

20 69 69 69 69 69 69 69 69 20 20 69 69 69 69 20
20 75 75 75 75 75 75 75 75 20 20 75 75 75 75 20
20  9  9  9  9  9  9  9  9 68 70  9  9  9  9 20
20  9  9  9  9  9  9  9  9 74 76  9  9  9  9 20
20  9  9  9  9  9  9  9  9  9  9  9  9  9  9 20
20  9  9  9  9  9  9  9  9  9  9  9  9  9  9 20
20  9  9  9  9  9  9  9  9  9  9  9  9  9  9 20
20  9  9  9  9  9  9  9  9  9  9  9  9  9  9 20
20  9  9  9  9  9  9  9  9  9  9  9  9  9  9 20
20  9  9  9  9  9  9  9  9  9  9  9  9  9  9 20
20  9  9  9  9  9  9  9  9  9  9  9  9  9  9 20
20  9  9  9  9  9  9  9  9  9  9  9  9  9  9 20
20  9  9  9  9  9  9  9  9  9  9  9  9  9  9 20
20 20 20 20 20 20 20 20 20 20 20 20 20 20 20 20

20 20 20 20 71 72 20 20 20 20 20 20 20 71 72 20
20 83 81 82 77 78 20 20 20 20 20 20 20 77 78 20
20 89 87 88 20 20 20 20 20 20 20 20 20 20 20 20
20 20 20 20 20 20 20 20 20 49 50 20 20 20 20 20
20 20 64 20 64 20 20 20 20 55 56 20 20 20 20 20
20 101 101 101 101 102 57 20 20 64 54 20 20 20 20 20
20 20 20 20 20 20 20 20 20 20 20 20 20 20 20 20
20 20 20 20 20 20 20 20 20 20 20 20 20 20 57 20
20 20 20 20 20 20 20 62 37 38 62 20 20 20 20 20
20 20 20 20 20 20 20 62 43 44 62 20 20 20 20 20
20 20 20 20 20 20 20 20 20 20 20 20 20 20 20 20
20 20 20 20 20 20 20 20 20 20 20 20 20 20 57 20
20 20 20 106 107 108 20 20 20 20 20 20 20 20 20 20
20 20 20 20 20 20 20 20 20 20 20 20 20 20 20 20

20 20 20 20 20 20 20 20 20 20 20 20 20 20 20 20
20 20 20 20 20 20 20 20 20 20 20 20 20 20 20 20
20 20 20 20 20 20 20 20 20 20 20 20 20 20 20 20
20 20 20 20 20 20 20 20 20 20 20 20 20 20 20 20
20 95 95 95 95 96 51 20 20 20 20 20 20 20 20 20
20 20 20 20 20 20 20 20 20 20 20 20 20 20 20 20
20 20 20 20 20 20 20 20 20 20 20 20 20 20 51 20
20 20 20 20 20 20 20 20 31 32 20 20 20 20 20 20
20 20 20 20 20 20 20 20 20 20 20 20 20 20 20 20
20 20 20 20 20 20 20 20 20 20 20 20 20 20 20 20
20 20 20 20 20 20 20 20 20 20 20 20 20 20 51 20
20 20 20 20 20 20 20 20 20 20 20 20 20 20 20 20
20 20 20 20 20 20 20 20 20 20 20 20 20 20 20 20
20 20 20 20 20 20 20 20 20 20 20 20 20 20 20 20
# TP 1 4 12 8 8 1
@