3 32 40
tileset1

1 1 1 1 1 1 1 1 1 1 1 1 1 0 0 0 0 1 1 1 1 1 1 1 1 1 1 1 1 1 1 1 
1 1 1 1 1 1 1 1 1 1 1 1 1 0 0 0 0 1 1 1 1 1 1 1 1 1 1 1 1 1 1 1 
1 1 1 1 1 0 0 0 0 0 0 0 0 0 0 0 0 0 0 0 0 0 0 0 0 1 1 1 1 1 1 1 
1 1 1 1 1 0 0 0 0 0 0 0 0 0 0 0 0 0 0 0 0 0 0 0 0 1 1 1 1 1 1 1 
1 1 1 1 1 2 2 2 2 2 1 1 1 2 2 2 2 2 2 0 0 0 0 0 0 1 1 1 1 1 1 1 
1 1 1 1 1 0 0 0 0 0 1 1 1 0 0 0 0 0 0 0 0 0 0 0 0 1 1 1 1 1 1 1 
1 1 1 1 1 0 0 0 0 0 1 1 1 0 0 0 0 0 0 0 0 0 0 0 0 1 1 1 1 1 1 1 
1 1 1 1 1 0 0 0 0 0 1 1 1 0 0 0 0 0 0 0 0 0 0 0 0 1 1 1 1 1 1 1 
1 1 1 1 1 0 0 0 0 0 1 1 1 0 0 0 0 0 0 0 0 0 0 0 0 1 1 1 1 1 1 1 
1 1 1 1 1 2 2 2 2 2 1 1 1 0 0 0 0 0 0 0 0 0 0 0 0 1 1 1 1 1 1 1 
1 1 1 1 1 0 0 0 0 0 1 1 1 0 0 0 0 0 0 0 0 0 0 0 0 1 1 1 1 1 1 1 
1 1 1 1 1 0 0 0 0 0 0 0 0 0 0 0 0 0 0 0 0 0 0 0 0 1 1 1 1 1 1 1 
1 1 1 1 1 0 0 0 0 0 0 0 0 0 0 0 0 0 0 0 0 0 0 0 0 1 1 1 1 1 1 1 
1 1 1 1 1 0 0 0 0 0 0 0 0 0 0 0 0 0 0 0 0 0 0 0 0 1 1 1 1 1 1 1 
1 1 1 1 1 1 1 2 2 2 2 2 1 1 1 1 1 1 1 0 0 0 0 0 0 1 1 1 1 1 1 1 
1 1 1 1 1 1 1 0 0 0 0 0 1 1 1 1 1 1 1 0 0 0 0 0 0 1 1 1 1 1 1 1 
1 1 1 1 1 0 0 0 0 0 0 0 0 0 0 0 0 0 0 0 0 0 0 0 0 1 1 1 1 1 1 1 
1 1 1 1 1 0 0 0 0 0 0 0 0 0 0 0 0 0 0 0 0 0 0 0 0 1 1 1 1 1 1 1 
1 1 1 1 1 0 0 0 0 0 0 0 0 0 0 0 0 0 0 0 0 0 0 0 0 1 1 1 1 1 1 1 
1 1 1 1 1 2 2 0 2 2 2 2 0 0 2 2 2 2 2 2 2 2 2 2 2 1 1 1 1 1 1 1 
1 1 1 1 1 0 0 0 0 0 0 0 0 0 0 0 0 0 0 0 0 0 0 0 0 1 1 1 1 1 1 1 
1 1 1 1 1 0 0 0 0 0 0 0 0 0 0 0 0 0 0 0 0 0 0 0 0 1 1 1 1 1 1 1 
1 1 1 1 1 0 0 0 0 0 0 0 0 0 0 0 0 0 0 0 0 0 0 0 0 1 1 1 1 1 1 1 
1 1 1 1 1 0 0 0 0 0 0 0 0 0 0 0 0 0 0 0 0 0 0 0 0 1 1 1 1 1 1 1 
1 1 1 1 1 1 1 1 1 1 1 1 1 1 1 0 0 0 0 0 0 0 0 0 0 1 1 1 1 1 1 1 
1 1 1 1 1 1 1 1 1 1 1 1 1 1 1 0 0 0 0 0 0 2 2 2 2 1 1 1 1 1 1 1 
1 1 1 1 1 0 0 0 0 0 0 0 0 0 0 0 0 0 0 0 0 0 0 0 0 1 1 1 1 1 1 1 
1 1 1 1 1 0 0 0 0 0 0 0 0 0 0 0 0 0 0 0 0 0 0 0 0 1 1 1 1 1 1 1 
1 1 1 1 1 0 0 0 0 0 0 0 0 0 0 0 0 0 0 0 0 0 0 0 0 1 1 1 1 1 1 1 
1 1 1 1 1 0 0 0 0 0 0 0 0 0 0 0 0 0 0 0 0 0 0 0 0 1 1 1 1 1 1 1 
1 1 1 1 1 2 2 2 2 0 0 0 2 2 2 2 2 2 2 2 2 2 2 2 2 1 1 1 1 1 1 1 
1 1 1 1 1 0 0 0 0 0 0 0 0 0 0 0 0 0 0 0 0 0 0 0 0 1 1 1 1 1 1 1 
1 1 1 1 1 0 0 0 0 0 0 0 0 0 0 0 0 0 0 0 0 0 0 0 0 1 1 1 1 1 1 1 
1 1 1 1 1 0 0 0 0 0 0 0 0 0 0 0 0 0 0 0 0 0 0 0 0 1 1 1 1 1 1 1 
1 1 1 1 1 0 0 0 0 0 0 0 0 0 0 0 0 0 0 0 0 0 0 0 0 1 1 1 1 1 1 1 
1 1 1 1 1 1 1 1 1 1 1 1 1 1 1 0 0 1 1 1 1 1 1 1 1 1 1 1 1 1 1 1 
1 1 1 1 1 0 0 0 0 0 0 0 0 0 1 0 0 1 0 0 0 0 0 0 0 1 1 1 1 1 1 1 
1 1 1 1 1 0 0 0 0 0 0 0 0 0 1 0 0 1 0 0 0 0 0 0 0 1 1 1 1 1 1 1 
1 1 1 1 1 1 1 1 1 1 1 1 1 1 1 0 0 1 1 1 1 1 1 1 1 1 1 1 1 1 1 1 
1 1 1 1 1 1 1 1 1 1 1 1 1 1 1 0 0 1 1 1 1 1 1 1 1 1 1 1 1 1 1 1 
271 271 271 271 271 271 271 271 271 271 271 271 271 283 284 284 285 271 271 271 271 271 271 271 271 271 271 271 271 271 271 271 
271 271 271 271 271 271 271 271 271 271 271 271 271 283 284 284 285 271 271 271 271 271 271 271 271 271 271 271 271 271 271 271 
271 271 271 271 271 271 271 271 271 271 271 271 271 283 284 284 281 278 278 278 278 278 278 278 279 271 271 271 271 271 271 271 
271 271 271 271 271 271 271 271 271 271 271 271 271 289 290 290 290 290 290 290 290 286 284 284 285 271 271 271 271 271 271 271 
271 271 271 271 271 271 271 271 271 271 271 271 271 271 271 271 271 271 271 271 271 289 290 290 291 271 271 271 271 271 271 271 
271 271 271 271 271 271 271 271 271 271 271 271 271 271 271 271 271 271 271 271 271 271 271 271 271 271 271 271 271 271 271 271 
271 271 271 271 271 271 271 271 271 271 271 271 271 271 271 271 271 271 271 271 271 271 271 271 271 271 271 271 271 271 271 271 
271 271 271 271 271 271 271 271 271 271 271 271 271 271 271 271 271 271 271 271 271 271 271 271 271 271 271 271 271 271 271 271 
271 271 271 271 271 271 271 271 271 271 271 271 271 271 271 271 271 271 271 271 271 271 271 271 271 271 271 271 271 271 271 271 
271 271 271 271 271 271 271 271 271 271 271 271 271 271 271 271 271 271 271 271 271 271 271 271 271 271 271 271 271 271 271 271 
271 271 271 271 271 271 271 271 271 271 271 271 271 271 271 271 277 278 278 278 278 278 278 278 279 271 271 271 271 271 271 271 
271 271 271 271 271 272 271 271 271 271 271 271 271 271 271 271 283 284 287 290 290 290 290 290 291 271 271 271 271 271 271 271 
271 271 271 271 271 271 272 271 271 271 271 271 271 271 271 271 289 290 291 271 271 271 271 271 271 271 271 271 271 271 271 271 
271 271 271 271 271 271 271 271 271 271 271 271 271 271 271 271 271 271 271 271 271 271 271 271 271 271 271 271 271 271 271 271 
271 271 271 271 271 271 271 271 271 271 271 271 271 271 271 271 271 271 271 271 271 271 271 271 271 271 271 271 271 271 271 271 
271 271 271 271 271 271 271 271 271 271 271 271 271 271 271 271 271 271 271 271 271 271 271 271 271 271 271 271 271 271 271 271 
271 271 271 271 271 271 271 271 271 271 271 271 271 271 271 271 277 278 279 271 271 271 271 271 271 271 271 271 271 271 271 271 
271 271 271 271 271 271 271 271 277 278 278 278 278 278 278 278 280 284 285 271 271 271 272 271 272 271 271 271 271 271 271 271 
271 271 271 271 271 271 271 271 283 284 284 287 290 290 290 290 290 290 291 271 271 272 271 272 271 271 271 271 271 271 271 271 
271 271 271 271 271 271 271 271 283 284 284 285 271 271 271 271 271 271 271 271 271 271 271 271 271 271 271 271 271 271 271 271 
271 271 271 271 271 271 271 271 283 284 284 281 278 278 278 278 278 278 278 278 278 278 278 278 279 271 271 271 271 271 271 271 
271 271 271 271 271 271 271 271 289 290 290 290 290 290 290 290 290 290 290 290 290 286 284 284 285 271 271 271 271 271 271 271 
271 271 271 271 271 271 271 271 271 271 271 271 271 271 271 271 271 271 271 271 271 283 284 284 285 271 271 271 271 271 271 271 
271 271 271 271 271 271 271 271 271 271 271 271 271 271 271 271 271 271 271 271 271 283 284 284 285 271 271 271 271 271 271 271 
271 271 271 271 271 271 271 271 271 271 271 271 271 271 271 271 271 271 271 271 271 283 284 284 285 271 271 271 271 271 271 271 
271 271 271 271 271 271 271 271 271 271 271 271 271 271 271 271 271 271 271 271 271 283 284 284 285 271 271 271 271 271 271 271 
271 271 271 271 271 271 272 271 272 271 271 271 271 271 271 271 271 271 271 271 271 283 284 284 285 271 271 271 271 271 271 271 
271 271 271 271 271 272 271 272 271 271 271 271 271 271 271 271 271 271 271 271 271 283 284 284 285 271 271 271 271 271 271 271 
271 271 271 271 271 277 278 278 278 278 278 278 278 278 278 278 278 278 278 278 278 280 284 284 285 271 271 271 271 271 271 271 
271 271 271 271 271 289 290 290 290 290 290 290 290 290 286 284 284 287 290 290 290 290 290 290 291 271 271 271 271 271 271 271 
271 271 271 271 271 271 271 271 271 271 271 271 271 271 283 284 284 285 271 271 271 271 271 271 271 271 271 271 271 271 271 271 
271 271 271 271 271 271 271 271 271 271 271 271 271 271 283 284 284 285 271 271 271 271 271 271 271 271 271 271 271 271 271 271 
271 271 271 271 271 271 271 271 271 271 271 271 271 271 283 284 284 285 271 271 271 271 271 271 271 271 271 271 271 271 271 271 
271 271 271 271 271 271 271 271 271 271 271 271 271 271 289 290 290 291 271 271 271 271 271 272 271 271 271 271 271 271 271 271 
271 271 271 271 271 271 271 271 271 271 271 271 271 271 271 271 271 271 271 271 271 271 271 271 272 271 271 271 271 271 271 271 
271 271 271 271 271 271 271 271 271 271 271 271 271 271 271 271 271 271 271 271 271 271 271 271 271 271 385 271 271 271 271 271 
271 271 271 271 271 271 271 271 273 271 271 271 271 272 271 271 271 271 271 271 271 271 271 271 273 271 271 271 271 271 271 271 
271 271 271 271 271 271 271 271 271 271 271 271 271 271 271 271 271 271 271 271 271 271 271 271 271 271 271 271 271 271 271 271 
271 271 271 271 271 271 271 271 271 271 271 271 271 271 271 271 271 271 271 271 271 271 271 271 271 271 271 271 271 271 271 271 
271 271 271 271 271 271 271 271 271 271 271 271 271 271 271 271 271 271 271 271 271 271 271 271 271 271 271 271 271 271 271 271 

387 388 387 388 393 392 393 392 393 392 393 392 395 20 20 20 20 391 392 393 392 393 392 393 392 385 386 387 386 387 386 387 
387 388 387 388 399 398 399 398 399 398 399 398 401 20 20 20 20 397 398 399 398 399 398 399 398 401 386 387 386 387 386 387 
387 388 387 388 389 20 20 20 20 20 20 20 20 20 20 20 20 20 20 20 20 20 20 20 20 385 386 387 386 387 386 387 
387 388 387 388 389 20 20 20 20 20 20 20 20 20 20 20 20 20 20 20 20 20 20 20 20 385 386 387 386 387 386 387 
387 388 387 388 389 493 494 494 494 495 385 386 389 493 494 494 494 494 495 20 20 20 20 20 20 385 386 387 386 387 386 387 
387 388 387 388 389 20 20 20 20 20 385 386 389 180 180 180 180 180 180 180 180 180 180 180 180 385 386 387 386 387 386 387 
387 388 387 388 389 20 20 20 20 20 385 386 389 180 180 180 180 180 180 180 180 180 180 180 180 385 386 387 386 387 386 387 
387 388 387 388 389 20 20 20 20 20 385 386 389 180 180 180 180 180 180 180 180 180 180 180 180 385 386 387 386 387 386 387 
387 388 387 388 389 20 20 20 20 20 385 386 389 180 180 180 180 180 180 180 180 180 180 180 180 385 386 387 386 387 386 387 
387 388 387 388 389 493 494 494 494 495 391 392 395 180 180 180 180 180 180 180 180 180 180 180 180 385 386 387 386 387 386 387 
387 388 387 388 389 20 20 20 20 20 397 400 401 20 20 20 20 20 20 20 20 20 20 20 20 385 386 387 386 387 386 387 
387 388 387 388 389 20 20 20 20 20 20 20 20 20 20 20 20 20 20 20 20 20 20 20 20 385 386 387 386 387 386 387 
387 388 387 388 389 20 20 20 20 20 20 20 20 20 20 20 20 20 20 180 180 180 180 180 180 385 386 387 386 387 386 387 
387 388 387 388 389 20 20 20 20 20 20 20 20 20 20 20 20 20 20 180 180 180 180 180 180 385 386 387 386 387 386 387 
387 388 387 388 393 392 395 493 494 494 494 495 391 392 393 392 393 392 395 180 180 180 180 180 180 385 386 387 386 387 386 387 
387 388 387 388 397 398 401 20 20 20 20 20 397 398 399 398 399 400 401 180 180 180 180 180 180 385 386 387 386 387 386 387 
387 388 387 388 389 20 20 20 20 20 20 20 20 20 20 20 20 20 20 180 180 180 180 180 180 385 386 387 386 387 386 387 
387 388 387 388 389 20 20 20 20 20 20 20 20 20 20 20 20 20 20 20 20 20 20 20 20 385 386 387 386 387 386 387 
387 388 387 388 389 20 20 20 20 20 20 20 20 20 20 20 20 20 20 20 20 20 20 20 20 385 386 387 386 387 386 387 
387 388 387 388 389 493 495 20 493 494 494 495 20 20 493 494 494 494 494 494 494 494 494 494 495 385 386 387 386 387 386 387 
387 388 387 388 389 20 20 20 20 20 20 20 20 20 20 20 20 20 20 20 20 20 20 20 20 385 386 387 386 387 386 387 
387 388 387 388 389 20 20 20 20 20 20 20 20 20 20 20 20 20 20 20 20 20 20 20 20 385 386 387 386 387 386 387 
387 388 387 388 389 20 20 20 20 20 20 20 20 20 20 20 20 20 20 20 20 20 20 20 20 385 386 387 386 387 386 387 
387 388 387 388 389 20 20 20 20 20 20 20 20 20 20 180 180 180 180 180 180 20 20 20 20 385 386 387 386 387 386 387 
387 388 387 388 393 392 393 392 393 392 393 392 393 392 395 180 180 180 180 180 180 20 20 20 20 385 386 387 386 387 386 387 
387 388 387 388 397 398 399 398 399 398 399 398 399 400 401 180 180 180 180 180 180 493 494 494 495 385 386 387 386 387 386 387 
387 388 387 388 389 20 20 20 20 20 20 20 20 20 20 180 180 180 180 180 180 20 20 20 20 385 386 387 386 387 386 387 
387 388 387 388 389 20 20 20 20 20 20 20 20 20 20 180 180 180 180 180 180 20 20 20 20 385 386 387 386 387 386 387 
387 388 387 388 389 20 20 20 20 20 20 20 20 20 20 20 20 20 20 20 20 20 20 20 20 385 386 387 386 387 386 387 
387 388 387 388 389 20 20 20 20 20 20 20 20 20 20 20 20 20 20 20 20 20 20 20 20 385 386 387 386 387 386 387 
387 388 387 388 389 493 494 494 495 20 20 20 233 493 494 494 494 494 494 494 494 494 494 494 495 385 386 387 386 387 386 387 
387 388 387 388 389 20 20 180 180 180 180 180 180 180 20 20 20 20 20 20 180 180 180 180 180 385 386 387 386 387 386 387 
387 388 387 388 389 20 20 180 180 180 180 180 180 180 20 20 20 20 20 20 180 180 180 180 180 385 386 387 386 387 386 387 
387 388 387 388 389 180 180 180 180 180 180 180 20 20 20 20 20 20 180 180 180 180 180 20 20 385 386 387 386 387 386 387 
387 388 387 388 389 180 180 180 180 180 180 180 20 20 20 180 180 20 180 180 180 180 180 20 20 385 386 387 386 387 386 387 
387 388 387 388 212 212 212 212 212 212 212 212 212 212 201 180 180 199 212 212 212 212 212 212 212 212 386 387 386 387 386 387 
387 388 387 388 389 20 20 20 20 20 20 20 20 20 207 180 180 205 20 20 20 20 20 20 20 385 386 387 386 387 386 387 
387 388 387 388 389 380 381 380 381 380 381 380 381 380 207 180 180 205 20 381 380 381 380 381 380 385 386 387 386 387 386 387 
387 388 387 388 387 388 387 388 387 388 387 388 387 388 207 180 180 205 388 387 388 387 388 387 388 387 388 387 388 387 388 387 
393 394 387 388 387 388 387 388 387 388 387 388 387 388 207 180 180 205 388 387 388 387 388 387 388 387 388 387 388 387 388 387 

20 20 20 20 383 20 20 20 20 20 20 20 20 20 20 20 20 20 20 20 20 20 20 20 20 393 20 20 20 20 20 20 
20 20 20 20 389 20 20 20 20 20 20 20 20 20 20 20 20 20 20 20 20 20 20 20 20 385 20 20 20 20 20 20 
20 20 20 20 20 20 20 20 20 20 20 20 20 20 20 20 20 20 20 20 20 20 20 20 20 20 20 20 20 20 20 20 
20 20 20 20 20 20 20 20 20 20 379 380 383 20 20 20 20 20 20 20 20 20 20 20 20 20 20 20 20 20 20 20 
20 20 20 20 20 20 20 20 20 20 20 20 20 20 20 20 20 20 20 20 20 20 20 20 20 20 20 20 20 20 20 20 
20 20 20 20 20 20 20 20 20 20 20 20 20 20 20 20 20 20 20 20 20 20 20 20 20 20 20 20 20 20 20 20 
20 20 20 20 20 20 20 20 20 20 20 20 20 20 20 20 20 20 20 20 20 20 20 20 20 20 20 20 20 20 20 20 
20 20 20 20 20 20 20 20 20 20 20 20 20 20 20 20 20 20 20 20 20 20 20 20 20 20 20 20 20 20 20 20 
20 20 20 20 20 20 20 20 20 20 20 20 20 20 20 20 20 20 20 20 20 20 20 20 20 20 20 20 20 20 20 20 
20 20 20 20 20 20 20 20 20 20 20 20 20 20 20 20 20 20 20 20 20 20 20 20 20 20 20 20 20 20 20 20 
20 20 20 20 20 20 20 20 20 20 20 20 20 20 20 20 20 20 20 20 20 20 20 20 20 20 20 20 20 20 20 20 
20 20 20 20 20 20 20 20 20 20 20 20 20 20 20 20 20 20 20 20 20 20 20 20 20 20 20 20 20 20 20 20 
20 20 20 20 20 20 20 20 20 20 20 20 20 20 20 20 20 20 20 20 20 20 20 20 20 20 20 20 20 20 20 20 
20 20 20 20 381 380 383 20 20 20 20 20 379 380 381 380 381 380 383 20 20 20 20 20 20 20 20 20 20 20 20 20 
20 20 20 20 389 20 20 20 20 20 20 20 20 20 20 20 20 20 20 20 20 20 20 20 20 20 20 20 20 20 20 20 
20 20 20 20 389 20 20 20 20 20 20 20 20 20 20 20 20 20 20 20 20 20 20 20 20 20 20 20 20 20 20 20 
20 20 20 20 20 20 20 20 20 20 20 20 20 20 20 20 20 20 20 20 20 20 20 20 20 20 20 20 20 20 20 20 
20 20 20 20 20 20 20 20 20 20 20 20 20 20 20 20 20 20 20 20 20 20 20 20 20 20 20 20 20 20 20 20 
20 20 20 20 20 20 20 20 20 20 20 20 20 20 20 20 20 20 20 20 20 20 20 20 20 20 20 20 20 20 20 20 
20 20 20 20 20 20 20 20 20 20 20 20 20 20 20 20 20 20 20 20 20 20 20 20 20 20 20 20 20 20 20 20 
20 20 20 20 20 20 20 20 20 20 20 20 20 20 20 20 20 20 20 20 20 20 20 20 20 20 20 20 20 20 20 20 
20 20 20 20 20 20 20 20 20 20 20 20 20 20 20 20 20 20 20 20 20 20 20 20 20 20 20 20 20 20 20 20 
20 20 20 20 20 20 20 20 20 20 20 20 20 20 20 20 20 20 20 20 20 20 20 20 20 20 20 20 20 20 20 20 
20 20 20 20 381 380 381 380 381 380 381 380 381 380 383 20 20 20 20 20 20 20 20 20 20 20 20 20 20 20 20 20 
20 20 20 20 389 20 20 20 20 20 20 20 20 20 20 20 20 20 20 20 20 20 20 20 20 20 20 20 20 20 20 20 
20 20 20 20 389 20 20 20 20 20 20 20 20 20 20 20 20 20 20 20 20 20 20 20 20 20 20 20 20 20 20 20 
20 20 20 20 20 20 20 20 20 20 20 20 20 20 20 20 20 20 20 20 20 20 20 20 20 20 20 20 20 20 20 20 
20 20 20 20 20 20 20 20 20 20 20 20 20 20 20 20 20 20 20 20 20 20 20 20 20 20 20 20 20 20 20 20 
20 20 20 20 20 20 20 20 20 20 20 20 20 20 20 20 20 20 20 20 20 20 20 20 20 20 20 20 20 20 20 20 
20 20 20 20 20 20 20 20 20 20 20 20 227 20 20 20 20 20 20 20 20 20 20 20 20 20 20 20 20 20 20 20 
20 20 20 20 20 20 20 20 20 20 20 20 20 20 20 20 20 20 20 20 20 20 20 20 20 20 20 20 20 20 20 20 
20 20 20 20 20 20 20 20 20 20 20 20 20 20 20 20 20 20 20 20 20 20 20 20 20 20 20 20 20 20 20 20 
20 20 20 20 20 20 20 20 20 20 20 20 20 20 20 20 20 20 20 20 20 20 20 20 20 20 20 20 20 20 20 20 
20 20 20 20 20 20 20 20 20 20 20 20 20 20 20 20 20 20 20 20 20 20 20 20 20 20 20 20 20 20 20 20 
20 20 20 20 20 20 20 20 20 20 20 20 20 20 20 20 20 20 20 20 20 20 20 20 20 20 20 20 20 20 20 20 
20 20 20 20 389 20 20 20 20 20 20 20 20 20 20 20 20 20 20 20 20 20 20 20 20 385 386 20 20 20 20 20 
20 20 20 20 20 20 20 20 20 20 20 20 20 20 20 20 20 20 20 20 20 20 20 20 20 20 20 20 20 20 20 20 
20 20 20 20 379 20 20 20 20 20 20 20 20 20 383 20 20 379 380 20 20 20 20 20 20 381 20 20 20 20 20 20 
20 20 20 20 381 20 20 20 20 20 20 20 20 20 389 20 20 385 20 20 20 20 20 20 20 20 20 20 20 20 20 20 
20 20 20 20 20 20 20 20 20 20 20 20 20 20 389 20 20 385 20 20 20 20 20 20 0 20 20 20 20 20 20 20 

# TP 1 15 38 14 1 1
# TP 1 16 38 14 1 1
@